######## 
S  #   
## # 
## # 
#  # #
# ## #
#    #
##########